1222222222222222222222222222222222222222222222222222222222222222222222222222222223
0888888888888888888888888888888888888888888888888888888888888888888888888888888884
0888888888888888888888888888888888888888888888888888888888888888888888888888888884
0888888888888888888888888888888888888888888888888888888888888888888888888888888884
0888888888888888888888888888888888888888888888888888888888888888888888888888888884
0888888888888888888888888888888888888888888888888888888888888888888888888888888884
0888888888888888888888888888888888888888888888888888888888888888888888888888888884
0888888888888888888888888888888888888888888888888888888888888888888888888888888884
0888888888888888888888888888888888888888888888888888888888888888888888888888888884
0888888888888888888888888888888888888888888888888888888888888888888888888888888884
0888888888888888888888888888888888888888888888888888888888888888888888888888888884
0888888888888888888888888888888888888888888888888888888888888888888888888888888884
0888888888888888888888888888888888888888888888888888888888888888888888888888888884
0888888888888888888888888888888888888888888888888888888888888888888888888888888884
0888888888888888888888888888888888888888888888888888888888888888888888888888888884
0888888888888888888888888888888888888888888888888888888888888888888888888888888884
0888888888888888888888888888888888888888888888888888888888888888888888888888888884
0888888888888888888888888888888888888888888888888888888888888888888888888888888884
0888888888888888888888888888888888888888888888888888888888888888888888888888888884
0888888888888888888888888888888888888888888888888888888888888888888888888888888884
0888888888888888888888888888888888888888888888888888888888888888888888888888888884
0888888888888888888888888888888888888888888888888888888888888888888888888888888884
0888888888888888888888888888888888888888888888888888888888888888888888888888888884
0888888888888888888888888888888888888888888888888888888888888888888888888888888884
0888888888888888888888888888888888888888888888888888888888888888888888888888888884
0888888888888888888888888888888888888888888888888888888888888888888888888888888884
0888888888888888888888888888888888888888888888888888888888888888888888888888888884
0888888888888888888888888888888888888888888888888888888888888888888888888888888884
0888888888888888888888888888888888888888888888888888888888888888888888888888888884
0888888888888888888888888888888888888888888888888888888888888888888888888888888884
0888888888888888888888888888888888888888888888888888888888888888888888888888888884
0888888888888888888888888888888888888888888888888888888888888888888888888888888884
0888888888888888888888888888888888888888888888888888888888888888888888888888888884
0888888888888888888888888888888888888888888888888888888888888888888888888888888884
0888888888888888888888888888888888888888888888888888888888888888888888888888888884
0888888888888888888888888888888888888888888888888888888888888888888888888888888884
0888888888888888888888888888888888888888888888888888888888888888888888888888888884
0888888888888888888888888888888888888888888888888888888888888888888888888888888884
0888888888888888888888888888888888888888888888888888888888888888888888888888888884
0888888888888888888888888888888888888888888888888888888888888888888888888888888884
0888888888888888888888888888888888888888888888888888888888888888888888888888888884
0888888888888888888888888888888888888888888888888888888888888888888888888888888884
0888888888888888888888888888888888888888888888888888888888888888888888888888888884
0888888888888888888888888888888888888888888888888888888888888888888888888888888884
0888888888888888888888888888888888888888888888888888888888888888888888888888888884
7666666666666666666666666666666666666666666666666666666666666666666666666666666665