12222222222222223
08888888888888884
08888888888888884
08888888888888884
08888888888888884
08888888888888884
08888888888888884
08888888888888884
08888888888888884
76666666666666665